100000000000000000000000000000000000000000000000000000000000000000000000000000000000000000000000000000000000000000000000000000000000000000000000000000000000000000000000000000000000000000
100000000000000000000000000000000000000000000000000000000000000000000000000000000000000000000000000000000000000000000000000000000000000000000000000000000000000000000000000000000000000000
100000000000000000000000000000000000000000000000000000000000000000000000000000000000000000000000000000033300000000000000000000000000000000000000000000000000000000000000000000003000000000
100000003030000000000000000000000000000000000000000000000000000000000000000000000000000000000000000000000000000000000000000000000000000000000000000000000000000000000000000000033000000000
100000300000000000000000000000000000000000000000000000000111111000000000000000000000000000000000000000000000000000000000000111100000000000000000000000000000000000000000000000333000000000
100003300000000000000000000000000000000000000000000001111000000111000000000000002200000111100000000000333300000000000000000000000000000000000000300000000000000000000000000003333000000000
100033300000000024000000000000020050050050100000000000400000000000000055000550022224000000000000400000000000001010140000000000040000000000050503340000000000003400000000000033333000600000
111111111111111111111111111111111111111111111111111111111111111111111111111111111111111111111111111111111111111111111111111111111111111111111111111111111111111111111111111111111111111111