100000000000000000000000000000000000000000000000000000000000000000000000000000000000000000000000000000000000000000000000000000000000000000000000000000000000000000000000000000000000000000
100000000000000000000000000000000000000000000000000000000000000000000000000000000000000000000000000000000000000000000000000000000000000000000000000000000000000000000000000000000000000000
100000000000000000000000000000000000000000000000000000000000000000000000000000000000000000000000000000000000000000000000000000000000000000000000000000000000000000000000000000000000000000
100000000000011110000000000000000000000000001111000000000000000000000000000000000000000000000000000000000000000300000000000000000000000000000000100000000000000000000000000000000000000000
100000000033000000111100000000000000000333300000033330000000000000000000000000000000000000111100000000000000003300000000000000000000000000000001100000000000000000000000000000000000000000
100000000333000000000000000000000011110000000000000000000500000022220000000000000000000000000000005050505000033300000000000000000000000000000011100000000000000000000000000000000000000000
100000003333400000000000050500040000000000000400000000000000000040000000000000000500500500000040000000000000333340000000000000222050505000000111100000000000060000000000000000000000000000
111111111111111111111111111111111111111111111111111111111111111111111111111111111111111111111111111111111111111111111111111111111111111111111111111111111111111111111111111111111111111111