1000000000000000000000000000000000000000000000000000
1000000000000000000000000000000000000000000000000000
1000000000030000000000000000000000000000000000000000
1000000000330000000000000000000000000000000000000000
1000000003330000000000000000000000000000000000000000
1000400033330000000000000000000000000000000000000000
1000000000000020200020000000000000000000000000000000
1111111111111111111111111111111111111111111111111111