1000000000000000000000000000000000000000000000000000
1000000000000000000000000000000000000000000000000000
1000000000030000000000000000000000000000000000000000
1000000000330000000000000000000000000000000000000000
1000000003330000000000000000000000000000000000000000
1000000033330000000000000000000000000000000000000000
1000000333330020200020000000000000000000000000000000
1111111111111111111111111111111111111111111111111111