1000000000000000000000000000000000000000000000000000
1000000000000000000000000000000000000000000000000000
1000000000030000000000000000000000000000000000000000
1000000000000000000000000000000000000000000000000000
1000000000000000000000000000000000000000000000000000
1000000000000000000000000000000000000000000000000000
1000000000000020200020000000000000000000000000000000
1111111111111111111111111111111111111111111111111111
