10000000000000000000000000000000000000000000000000000000000000000000000000000000000
10000000000000000000000000000000000000000000000000000000000000000000000000000000000
10000000000000000000000000000000000000000000000000000000000000000000000000000000000
10000000000000000000000000000000000000000000000000000000000000000000000000000000000
10000000000200000000000000000000000003000000000000000000000000000200000000000000000
10000000025200000000000000000000000030500000005550050055500000002200000000000000000
10000000222200004000000000000000000304000000000000000000000000022240000000000000600
11111111111111111111111111111111111111111111111111111111111111111111111111111111111