10000000000000000000000000000000000000000000000000000000000000000000000000000000000000000000000000000000000000000000000000000000000000000000000000000000000000000000000000000000000000000000
10000000000000000000000000000000000000000000000000000000000000000000000000000000000000000000000000000000000000000000000000000000000000000000000000000000000000000000000000000000000000000000
10000000000000000000000000000000000000000000000000000000000000000000000000000000000000000000000000000003330000000000000000000000000000000000000000000000000000000000000000000000000030000000
10000000303000000000000000000000000000000000000000000000000000000000000000000000000000000000000000000000000000000000000000000000000000000000000000000000000000000000000000000000000330000000
10000030000000000000000000000000000000000000000000000000011111100000000000000000000000000000000000000000000000000000000000011110000000000000000000000000000000000000000000000000003330000000
10000330000000000000000000000000000000000000000000000111100000011100000000000000220000011110000000000033330000000000000000000000000000000000000000300000000000000000000000000000033330000000
10003330000000002400000000000002005005005010000000000040000000000000005500055002222400000000000040000000000000101014000000000004000000000000050503340000000000000340000000000000333330006000
11111111111111111111111111111111111111111111111111111111111111111111111111111111111111111111111111111111111111111111111111111111111111111111111111111111111111111111111111111111111111111111