1000000000000000000000000000000000000000000000000000
1000000000000000000000000000000000000000000000000000
1000000000000000000000000000000000000000000000000000
1000000000100000000000000000000000000000000000000000
1000000001100000000000000000000000000000000000000000
1000000011100000000000000000000000000000000000000000
1000000111100000000000000000000000000000000000000000
1111111111111111111111111111111111111111111111111111